t/F:I/F:x/F:y/F:z/F:B/F:B_I0_T0/F:B_I0
1 0 0 0 50	-1.975 0.004 0.051
1 0 0 0 45	-2.138 0.004 0.051
1 0 0 0 40	-2.327 0.004 0.051
1 0 0 0 35	-2.59  0.004 0.051
1 0 0 0 30	-2.258 0.004 0.051
1 0 0 0 28	-1.937 0.004 0.051
1 0 0 0 26	-1.32  0.004 0.051
1 0 0 0 24	-0.722 0.004 0.051
1 0 0 0 22	-0.585 0.004 0.051
1 0 0 0 20	-0.46  0.004 0.051
1 0 0 0 18	-0.405 0.004 0.051
1 0 0 0 16	-0.402 0.004 0.051
1 0 0 0 14	-0.42  0.004 0.051
1 0 0 0 12	-0.445 0.004 0.051
1 0 0 0 10	-0.466 0.004 0.051
1 0 0 0 9	-0.478 0.004 0.051
1 0 0 0 8	-0.484 0.004 0.051
1 0 0 0 7	-0.491 0.004 0.051
1 0 0 0 6	-0.491 0.004 0.051
1 0 0 0 5	-0.5   0.004 0.051
1 0 0 0 4	-0.504 0.004 0.051
1 0 0 0 3	-0.505 0.004 0.051
1 0 0 0 2	-0.506 0.004 0.051
1 0 0 0 1	-0.509 0.004 0.051
1 0 0 0 0	-0.513 0.004 0.051
1 0 0 0 -1	-0.515 0.004 0.051
1 0 0 0 -2	-0.519 0.004 0.051
1 0 0 0 -3	-0.523 0.004 0.051
1 0 0 0 -4	-0.526 0.004 0.051
1 0 0 0 -5	-0.525 0.004 0.051
1 0 0 0 -6	-0.535 0.004 0.051
1 0 0 0 -7	-0.537 0.004 0.051
1 0 0 0 -8	-0.54  0.004 0.051
1 0 0 0 -9	-0.54  0.004 0.051
1 0 0 0 -10	-0.54  0.004 0.051
1 0 0 0 -12	-0.535 0.004 0.051
1 0 0 0 -14	-0.529 0.004 0.051
1 0 0 0 -16	-0.508 0.004 0.051
1 0 0 0 -18	-0.494 0.004 0.051
1 0 0 0 -20	-0.478 0.004 0.051
1 0 0 0 -22	-0.461 0.004 0.051
1 0 0 0 -24	-0.443 0.004 0.051
1 0 0 0 -26	-0.425 0.004 0.051
1 0 0 0 -28	-0.41  0.004 0.051
1 0 0 0 -30	-0.39  0.004 0.051
1 0 0 0 -35	-0.4   0.004 0.051
1 0 0 0 -40	-0.705 0.004 0.051
1 0 0 0 -45	-1.518 0.004 0.051
1 0 0 0 -50	-2.115 0.004 0.051
2 0 0 0 0       -0.511 0.004 0.051
3 0 0 0 0       -0.511 0.004 0.051
0 0 0 0 50      -1.967 0.004 0.051
0 0 0 0 45      -2.158 0.004 0.051
0 0 0 0 40      -2.378 0.004 0.051
0 0 0 0 35      -2.596 0.004 0.051
0 0 0 0 30      -2.318 0.004 0.051
0 0 0 0 28      -1.934 0.004 0.051
0 0 0 0 26      -1.326 0.004 0.051
0 0 0 0 24      -0.851 0.004 0.051
0 0 0 0 22      -0.589 0.004 0.051
0 0 0 0 20      -0.463 0.004 0.051
0 0 0 0 18      -0.409 0.004 0.051
0 0 0 0 16      -0.396 0.004 0.051
0 0 0 0 14      -0.411 0.004 0.051
0 0 0 0 12      -0.439 0.004 0.051
0 0 0 0 10      -0.461 0.004 0.051
0 0 0 0 9       -0.471 0.004 0.051
0 0 0 0 8       -0.479 0.004 0.051
0 0 0 0 7       -0.486 0.004 0.051
0 0 0 0 6       -0.493 0.004 0.051
0 0 0 0 5       -0.493 0.004 0.051
0 0 0 0 4       -0.499 0.004 0.051
0 0 0 0 3       -0.502 0.004 0.051
0 0 0 0 2       -0.505 0.004 0.051
0 0 0 0 1       -0.508 0.004 0.051
0 0 0 0 0       -0.597 0.004 0.051

 
